1 1 1 1 1 1
E 0 0 0 0 1
1 0 1 0 1 1
1 1 1 0 0 X
1 1 1 0 0 1
1 1 1 1 1 1